知的行動を代わる	に を	人間に
推論・判断をする	を	
記号処理を用いる	を	
記述をする	と を	主体と
注目を集める	が を	「サポートベクターマシン」が
学習を行う	に を	元に 経験を
流行を超える	を	
学習を繰り返す	を	
統計的学習をする	て で に は を を通して	ACT-Rでは、 なされている。 元に 推論ルールを、 生成規則を通して
進化を見せる	て において は を	加えて、 活躍している。 生成技術において （敵対的生成ネットワーク）は、
コンテンツ生成を行う	を	
機械式計算機をする	は を	ブレーズ・パスカルは
開発を行う	は を	エイダ・ラブレスは
プログラミング言語をする	は を	彼はまた
テストをする	を	
来談者中心療法を行う	を	
プログラミング言語をする	は を	アラン・カルメラウアーは
バックギャモン専用コンピュータ・TDギャモンをする	に は を	1992年に IBMは
投資全額を上回る	が を	コストが
意味付けをする	から に対して を	ここから 非構造化データに対して、
処理を行う	を	
知的処理を行う	に により を	Webに ティム・バーナーズ＝リーにより、 同年に、
意味をする	に を	データに
知的処理を行う	て に を	コンピュータに 付加して、
研究を進める	て を	費やして
命令をする	で を	機構で
運転をする	に を	元に
特許をする	が に まで を	2018年までに 日本が
研究をする	を	
運転をする	て に を	基づいて、 柔軟に
注目を集める	から は を	ことから、 ファジィは
ニューロファジィ制御をする	を	
成功を受ける	を	
知的制御を用いる	て も を	他社も 受けて、
開発工数を抑える	を	
制御をする	から を	少なさから、
知的制御をする	を	
表現する）をする	を	
進歩を担う	を	
精度改善を果たす	が で に を	2012年に チームが 画像処理コンテストで
専用プログラムを使う	を	
研究を続ける	が て を	ジェフ・ホーキンスが、 向けて
行動型システムを用いる	て は を	これは ものではなく、 登場している。
関連性を導き出す	を	
「ワンショット学習」をする	が を	データが
認識能力を持つ	を	
記号接地問題(シンボルグラウンディング問題)をする	に は を	8月には、
注目を集める	に を	急速に
普及を受ける	を	
機械学習を組み合わせる	を	
投資を行う	で に を	全世界的に 民間企業主導で
探索を行う	で を	無報酬で
推論をする	て を	経て
共同研究を始める	とも は を	Googleは、 マックスプランク研究所とも
研究を行う	て を	始めており、
研究開発をする	で は を	中国では 官民一体で
実験をする	を	
研究開発をする	で を	日本で
投資をする	に は まで を	2022年までに 韓国は、
深層学習をする	を	
脳シミュレーションを行う	を	
反乱を起こす	て に対して を	人間に対して 於いて、
弾圧を併せ持つ	を	
監視を行う	に まで を	人工知能に 歩行者まで
法的手続きを経る	を	ウイグル族を
監視社会化を恐れる	を	
監視カメラをする	を	
AI監視技術をする	に は を	世界各国に 中国は
差別を認める	を	
研究をする	を	
展開を変える	を	
戦争をする	を	
ファジィ制御をする	は を	AIプログラムは
判断を介す	から を	観点から
開発禁止令を出す	に を	2012年に
禁止を求める	が に は を	4月には ヒューマン・ライツ・ウォッチが、
運用をめぐる	を	
開発競争を行う	は を をめぐって	米国・中国・ロシアは 軍事利用をめぐって
記録をする	を	
自律無人艇を使う	を	
試験を行う	を	
「メイヴン計画」を行う	を	
追及を受ける	て で と とともに は を	「」とともに、 公聴会では、 拒否すると 整合性で 暴露されており、
共同研究をする	が を	Microsoftが
監視国家をする	が によって を	AIによって 中国が
無人攻撃機をする	で に を	中東で 大量に
反科学・反マイノリティ・地球温暖化懐疑論等をする	を	
解任をする	て は を	Google社員らは 含まれており、
解散をする	が で は を	Googleは 倫理委員会が 理由で、
霊的存在を見いだす	に を	ものに
道)」をする	を	
実現をする	を	
話をする	は を	哲学者は
意思疎通を行う	を	
勘違いをする	を	
議論を行う	まで を	「これまで
